111111
111111
1ECP11
10CC11
111011
100001
111111