11111111111111111111111111111111
1CCCC11111CCCCCC1111CCCC111CCCC1
1CCCC1CCC1CCCCCC1CCCCCCC111CCCC1
1CCCC11111CCCCCC1111CCCC111CCCC1
1CCCCCCCCCCCCCCCCCCCCCCCCCCCCCC1
1CCCC11111CCCCC1111111CCCCC11111
1CCCC1CCC1CCCCCCCCCCC1CCCCCCCCC1
1CCCC111111111111C1111CCCCC111C1
1CCCCCCCCCCCCCCC1CCCCCCCCCCCCCC1
1CC111111111CCCC1111C111111CCCC1
1CCCCCCCCCCCCCCCCCC1CCCC1CCCCCC1
1CCCC11111CCCCCC1111CCCC111CCCC1
1CCCC1CCC1CCCCCC1CCCCCCC111CCCC1
1CCCC11111CCCCCC1111CCCC111CCCC1
1CCCCCCCCCCCCCCCCCCCECPCCCCCCCC1
11111111111111111111111111111111
