11111111111111111111
1CCCCCCCCCCCCCCCCCC1
1C1111C11111C11111C1
1C1CCCCCC1CCCCCCC1C1
1C1C11111111111CC1C1
1C1C1CCCCC111CCCC1C1
1C1C11C111111C1CC1C1
1C1CCCC11CCCCC1CC1C1
1C1110111101111CC1C1
1CCCCCCCCCCCPECCCCC1
1C1111C11111C11111C1
1C1CCCCCC1CCCCCCC1C1
1C1C11111111111CC1C1
1C1C100000001CCCC1C1
1C1C111111111C1CC1C1
1C1CCCCCCCCCCC1CC1C1
1C11111111C1111CC1C1
1CCCCCCCCCCCCCCCCCC1
11111111111111111111