11111111111111111111111111111111
1CCCCCCCCCCCCCCCCCCCCCCCCCCCCCC1
1C111C11111C11C11111C11C11111CC1
1C1CPCCCCCCCC1CCCCCCCC1CCCCCCCC1
1C1C1111CC1CC11111C1CC1111CC1CC1
1C1C1CCCCC1CC1CCCCC1CC1CCCCC1CC1
1C1C1C111C1CC1C111C1CC1C111C1CC1
1CCC1C1CCC1CCCCCCCC1CCCCC1EC1CC1
1C111C1C1C1111CC1CC1111C111C1CC1
1C1CCCCC1CCCCCCCCCCCCCCCCCCCCCC1
1C1C11111111111111C11111111111C1
1CCCCCCCCCCCCCCCCCCCCCCCCCCCCCC1
11111111111111111111111111111111