11111111111111111111111111111111
1CCCCCCPCCCCCCCC1111111111111111
1C11111C111CCCCCCCCC111111111111
1C1CCC1C111C11111C11111111111111
1C111C1C111C1111CCCCCCCCC1111111
1C111C1C111C1111CC111111C1111111
1CCCCC1C111CCCCCCCCCCCCCC1111111
1111111C111111111C111111C1111111
1111111C1CCCCCCCCC11111CCCCCCCC1
1CCCCC1C111C11111C11111C11CCCCC1
1C111C1CCC1111111C11111CC1CCCCC1
1C111C1C1CCCCCCCCCCCCCCCCCCCCCC1
1C111C1C111111111C11111CC1CCCC11
1C111C1CCCCCCCCCCC11111CC1CCCCC1
1C11CC1C111C11111C111111C1CCCCC1
1C11111C111CCCCCCCCCCCCCC1CCCCC1
1CCCCECCCCCC11111C11111CCCCCCCC1
11111111111111111111111111111111